 A#####################################################################################################################################################
               #     #  #        #     #  #  #        #  #  #              #     #           #  #  #                          #  #           #     #  #
#######  ####  #  ####  #  ####  #  #  #  #  ####  #  #  #  #  #######  ####  #  #  ####  ####  #  #  ####  #  #############  #  #  #  #######  ####  #
#        #                 #     #  #     #  #     #  #        #              #  #  #           #     #  #  #  #        #     #  #  #  #     #     #  #
#  #  #  #######  ####  ##########  #  ####  #  #  #  ##########  #  ####  ##########  #  #######  ####  #############  #  ####  #  ####  ####  #  #  #
#  #  #  #     #     #           #  #     #     #  #  #     #     #  #        #        #     #     #     #     #  #     #  #        #  #     #  #     #
#  #  ####  #######  ####  ##########  ####  ####  #  #  #######  ####  #  ####  #  #  ####  #  ####  ####  ####  ####  #  #  ####  #  ####  #######  #
#  #        #  #  #  #        #  #        #  #  #  #  #     #     #  #  #     #  #  #     #           #     #  #     #  #  #  #  #     #  #  #  #     #
#  #  ####  #  #  ####  ####  #  #  ####  ####  #  #  #  #  #######  ####  #############  ####  ####  #  ####  #  ####  #  ####  ####  #  #  #  ####  #
#  #  #  #     #     #  #  #  #     #     #        #  #  #     #        #     #  #  #        #  #  #     #     #                                #     #
####  #  #  #  #  ####  #  #######  #######  #############  ####  #######  ####  #  #  ##########  #  #######  ##########  #  ##########  #  #######  #
#     #  #  #        #        #        #  #  #     #     #              #                          #  #  #                 #  #  #  #     #        #  #
#######  #  #  #######  #############  #  #  ####  ####  #  ###################  ####  #  #######  ####  ####  #  #############  #  ##########  #  #  #
#        #  #  #              #        #  #                 #  #     #        #  #  #  #  #           #  #     #  #           #                 #     #
####  #  #######  #  #  ####  ####  #  #  #  #  ##########  #  ####  #  #  #######  #  #  ####  #  ####  #######  ####  ####  #  ######################
#     #     #     #  #  #  #     #  #  #  #  #  #  #           #        #  #           #     #  #  #     #                 #  #                 #  #  #
#  #  ####  ##########  #  ####  #  #  #  #######  #  ####  ####  #  #  #########################  ####  ######################  ####  #######  #  #  #
#  #  #        #     #  #     #  #  #  #  #        #  #  #     #  #  #           #                          #  #  #     #        #  #  #  #     #     #
#  ####  #######  ##########  #  ####  #  #  #  #######  ####  #  #  ####  ####  ####  ####  #######  #  ####  #  #  #  #######  #  ####  #  ####  ####
#     #  #           #              #     #  #     #  #        #  #     #     #        #           #  #  #  #  #     #           #        #  #  #  #  #
#  #############  #  #  #  ####  #######  #######  #  ####  ################  #######  #  #  #  #  ####  #  #  #  #  ####  #  #  #######  #  #  #  #  #
#  #        #     #  #  #     #           #     #     #                    #        #  #  #  #  #  #    #     #  #  #  #  #  #  #        #           #
#  #  #  #  #  ####  ##########  #######  #  ####  ####  ####  #  #######  #  ##########  #  #############  ##########  #  #######  ##########  ####  #
#     #  #     #     #              #           #  #  #     #  #     #              #     #  #     #     #     #  #        #  #     #  #  #        #  #
#  ##########  #############  #  ################  #  #  #############  ################  #  ####  #  #  #  ####  #######  #  #  ####  #  #############
#  #     #  #              #  #  #  #  #  #  #     #  #  #  #                 #           #     #  #  #     #  #  #     #        #              #  #  #
#  #  ####  #######  #  ####  #  #  #  #  #  #  ####  #  #  #  ####  #  #  #############  #######  ####  #  #  #  #  ##########  ####  #######  #  #  #
#     #     #  #     #        #  #           #              #  #     #  #  #        #        #     #     #     #  #  #           #        #     #     #
####  #  ####  ####  #######  #  #  ################  ############################  #  ####  #  ####  ####  #  #  #  #############  ####  #######  ####
#     #              #        #     #     #  #        #              #  #        #     #           #  #     #     #  #  #  #           #              #
#######  ##########  #######  ####  #  ####  ####  #  #  ####  #######  #######  #  ####  ####  ##########  ####  #  #  #  ####  ##########  #  #######
#     #  #     #        #        #     #  #        #  #  #  #              #        #  #  #           #     #        #     #        #     #  #  #     #
#  #  #######  #  #######  #  ##########  ####  ##########  #  #  ####  ##########  #  ####  #  ####  #######  ####  #  ####  ##########  ####  #  #  #
#  #     #              #  #  #  #  #                 #        #     #  #     #           #  #  #  #  #     #  #  #  #  #     #     #     #     #  #  #
#  #  #  ##########  #  ####  #  #  #  #  ####  #############  #######  ####  #######  #  #######  #  ####  ####  #  #  ####  #  #  ####  #  #  #  #  #
#  #  #  #  #     #  #  #  #           #  #  #  #     #        #  #     #     #        #        #     #        #  #        #     #  #     #  #     #  #
#  ####  #  #  ####  #  #  #  #  ####  ####  #  #  ####  #  ####  ##########  #  #  #######  #  ####  #  #  ####  #  #  #  ####  #  #  #  ####  ####  #
#  #  #     #  #  #  #     #  #     #        #  #     #  #     #        #  #     #        #  #  #        #     #     #  #  #     #     #  #        #  #
#  #  #  ####  #  ####  #  #######  ####  ##########  #  ####  #######  #  ####  #  ####  ####  #######  #######  #############  #######  ####  #  #  #
#  #                 #  #        #  #                 #  #     #  #     #  #  #  #     #     #     #        #  #  #     #           #        #  #  #  #
#############  ####  #  #  #  #######  ####  ################  #  #  #  #  #  #  #  #######  ####  ####  #  #  #  ####  ####  ####  #############  ####
#  #           #     #  #  #  #  #  #  #        #     #     #     #  #       B   #  #     #  #     #  #  #  #  #  #  #  #  #  #        #  #     #  #  #
#  #  ####  #  #######  #  ####  #  #######  ####  #  #  #  #  #######  #  #  #  #######  #######  #  #  ####  #  #  #  #  #  #  #######  ####  ####  #
#        #  #           #     #     #              #  #  #        #  #  #  #  #           #        #                 #     #  #        #              #
#######  #  ##########  #  #  #  ####  #  #######  #######  #  ####  #############  #  ##########  ####  ####  #  #  #  #  ####  #  #######  #  #  #  #
#  #     #  #           #  #  #        #     #     #        #        #              #  #        #  #        #  #  #     #        #  #  #  #  #  #  #  #
#  ####  #########################  ####  #  #  #######  #  #  #  #  #  #  ####  #  #  #  ################  ##########  #######  #  #  #  #  #  #######
#  #     #     #        #  #           #  #  #           #  #  #  #  #  #     #  #  #     #              #        #           #  #     #  #  #  #     #
#  ####  #  ##########  #  ####  ################  #  #  #  #######  #######  #######  ####  #############  #  #  ####  #######  #######  ####  #  ####
#     #        #           #  #  #     #     #     #  #  #        #  #     #  #  #  #  #     #        #     #  #     #  #     #     #                 #
####  #  #######  ####  ####  #######  #  #  #  #  ####  #  ####  #######  ####  #  #  ####  #  #  ################  ####  ###################  ####  #
#           #  #  #     #  #           #  #     #  #     #  #     #           #     #           #  #              #        #  #  #           #     #  #
#  ####  #  #  ####  ####  ####  #######  ####  #############  ##########  ####  #  ##########  ####  ####  #  #  ####  ####  #  #  ####  #  ####  ####
#  #  #  #  #  #                 #     #     #     #     #        #           #  #        #     #     #     #  #  #           #        #  #  #  #     #
####  #  #  #  ################  #  #  ##########  ####  #  ####  #######  ##########  #  ####  #######  ####  ####  #  ####  #############  #  #  ####
#     #  #  #  #  #  #  #  #  #     #  #                 #  #  #           #     #  #  #              #  #  #        #     #  #  #  #     #           #
#  #######  #  #  #  #  #  #  #  #######  #############  ####  #  #############  #  #######  #######  ####  ################  #  #  ####  #  #  ####  #
#           #     #     #           #  #  #        #     #  #  #  #  #  #  #        #     #     #           #     #     #  #     #        #  #  #  #  #
####  #######  ####  #  #######  ####  #  #######  #######  #  ####  #  #  #  #  #  #  #############  #######  ####  ####  ####  ####  ####  #  #  ####
#  #        #  #     #     #     #  #     #  #                 #           #  #  #     #           #              #  #        #     #     #  #        #
#  #  #######  #  #  #  ####  #  #  #  #  #  #  #  #######  ##########  #  ##########  #######  ##########  #######  ####  #  #  ####  #  #  #  #######
#     #  #        #  #     #  #  #     #        #        #              #     #        #  #                                #  #  #  #  #     #        #
####  #  ####  #  ####  #  #  ##########  #  #############  ##########  #############  #  ##########  ####  #  #  #######  #######  #######  ##########
#  #     #     #  #     #        #        #  #  #  #  #           #                    #     #  #        #  #  #  #           #  #     #              #
#  #  ##########  ################  ##########  #  #  ####  ####  ####  ####  #  #######  ####  #  #############  #  #  #######  ####  #######  ####  #
#                 #  #        #  #  #        #  #  #           #  #  #     #  #              #     #     #        #  #              #  #        #     #
#  #######  ####  #  #######  #  #  #  #######  #  #######  ####  #  #######  #  ####  ####  ##########  #  ####  #  #  #############  #  #  #  #######
#  #        #  #        #              #        #  #     #     #  #  #  #     #  #        #     #              #  #  #  #        #        #  #  #  #  #
#  ####  #  #  ##########  #  #######  #  #######  #  #############  #  #######  #  ####  ###################  #  #############  ####  #  #  #  #  #  #
#     #  #     #     #  #  #        #     #     #           #        #        #  #     #  #                    #  #     #  #     #  #  #  #  #  #     #
##########  ####  #  #  ####  ####  ####  #  #######  ####  #  #  #  #  #  ####  #######  #  ######################  ####  ####  #  #  ####  ####  ####
#  #              #     #     #  #  #  #  #           #  #  #  #  #  #  #  #     #     #  #     #     #     #           #     #  #        #     #     #
#  #  #  ####  #  #######  #  #  ####  #  ####  #  ####  ##########  #  ##########  ####  #######  ####  ####  #  #  #######  #  ####  #  #######  ####
#     #     #  #  #  #  #  #  #        #        #        #     #  #        #                    #  #  #  #     #  #  #     #     #  #  #  #           #
####  ##########  #  #  #############  ####  #######  ####  #  #  #  ####  ####  ####  #  #  ####  #  #  #######  #  ####  #  ####  ####  #  ####  ####
#        #  #     #              #  #     #  #     #        #  #     #              #  #  #     #     #     #     #  #     #     #        #     #     #
##########  #######  #  #######  #  #  #  ####  #  ####  #######  ###################  ####  #  ####  #  #  ####  #  ####  #  #  ####  #  #  ####  #  #
#     #           #  #  #     #     #  #        #  #  #     #  #        #              #  #  #  #  #  #  #        #           #        #  #  #  #  #  #
#  #  ####  #  #  #######  #######  ####  ####  #  #  #######  #############  #######  #  #  #  #  #  #  #  ##########  #######  #############  ####  #
#  #        #  #  #  #  #     #        #  #     #     #  #        #        #        #     #  #        #  #           #  #           #                 #
#  #  ####  #  ####  #  ####  #  ####  #  #  ##########  #  ##########  #  ####  #######  ####  ####  ##########  ##########  ####  ####  ##########  #
#  #     #  #  #     #  #        #     #  #  #  #     #           #     #           #  #     #  #              #  #  #  #     #     #           #     #
#  ####  #######  #  #  ####  ####  #######  #  #  ##########  #  #######  #######  #  ##########  #######  #  #  #  #  #  #  #  #  #  #  #  ####  ####
#  #     #  #     #           #                 #  #           #     #     #  #        #  #     #     #     #  #  #        #  #  #     #  #  #     #  #
####  ####  ####  #######  ####  #  #  #######  #  ####  #  #######  ####  #  ####  ####  ####  #  #  ###################  ####  #  ################  #
#  #  #     #  #  #  #  #  #     #  #  #  #     #     #  #  #        #           #  #     #  #     #              #           #  #     #  #  #        #
#  #  #  #  #  #  #  #  ####  #######  #  #  #  #  ####  ####  #######  #  #######  #  ####  ##########  ####  #######  ################  #  ####  #  #
#        #              #     #  #     #     #  #  #  #     #           #  #  #     #  #           #     #                    #  #     #  #        #  #
#  ####  #  #  ####  ####  ####  #  #  #######  #  #  #############  #######  #######  #  #######  #######  #  #######  #  ####  #  ####  ####  ####  #
#     #  #  #  #  #  #  #  #        #        #     #     #                          #        #     #  #  #  #     #     #     #     #  #           #  #
#  #  #######  #  ####  #######  #  #######  #  #  ####  ####  ####  #############  #  #  #  #######  #  #  #######  ##########  ####  #######  ####  #
#  #  #     #     #           #  #        #  #  #  #     #     #  #  #        #  #  #  #  #        #           #     #     #     #     #        #  #  #
#  ####  #############  ####  #############  ####  #  #  #  ####  #  #  #  #  #  ##########  ####  ####  #############  #######  ####  ####  ####  #  #
#        #  #  #  #        #     #     #        #     #  #     #        #  #     #        #  #                       #        #  #        #  #  #     #
#######  #  #  #  #  #  #######  #  ###################  ####  #  #############  #  #  ##########  #  #######  #  ####  ####  #  #  #  #  #  #  #  #  #
#        #        #  #     #     #        #     #              #     #     #  #  #  #        #  #  #  #     #  #        #           #  #  #  #  #  #  #
####  #######  #######  #######  ####  #######  #  ##########  #  #######  #  #  #######  ####  ####  #  #######  #  #  ##########  #  #  #  #  ####  #
#           #           #        #  #              #           #  #     #        #           #     #  #  #        #  #  #     #  #  #  #     #     #  #
####  ####  #  ####  #######  ####  #  #######  #  #######  #######  ##########  #  ####  ####  ####  #  ##########  #######  #  #  #  #  ####  ####  #
#        #  #  #        #                 #     #  #              #                 #        #        #                 #           #  #     #        
####################################################################################################################################################  